19
19
       @     @   @ 
 @@@@@@@ @ @@@ @@@ 
     @ @ @         
 @ @@@ @@@ @@@@@ @ 
 @         @     @ 
 @@@@@ @ @@@@@ @@@@
 @   @ @ @     @   
 @ @@@@@@@@@@@ @ @@
 @ @     @         
 @ @ @ @@@@@ @@@ @@
 @   @ @     @     
@@@@@@ @ @@@ @@@@@@
 @     @ @         
 @@@@@ @ @@@@@ @@@ 
     @ @ @ @   @   
@@ @@@ @ @ @@@ @@@@
           @     @ 
 @@@@@ @ @@@@@ @@@ 
 @     @   @       
