19
19
       *     *   * 
 ******* * *** *** 
     * * *         
 * *** *** ***** * 
 *         *     * 
 ***** * ***** ****
 *   * * *     *   
 * *********** * **
 * *     *         
 * * * ***** *** **
 *   * *     *     
****** * *** ******
 *     * *         
 ***** * ***** *** 
     * * * *   *   
** *** * * *** ****
           *     * 
 ***** * ***** *** 
 *     *   *       
